########################################
#            ##############            #
# SCORE 0000 ############## SCORE 0000 #
#            ##############            #
########################################







#11111111111111111111111111111111111111#
##222222222222222222222222222222222222##
##333333333333333333333333333333333333##
###4444444444444444444444444444444444###
#####555555555555555555555555555555#####
#####666666666666666666666666666666#####
######7777777777777777777777777777######
########888888888888888888888888########
########################################
########################################
########################################
########################################
########################################